allow - позволять
however - однако
identifying - идентификация, определение
separate - отдельный
tell - рассказывать
harry - спешить
immediate area - ближайшее окружение
observe - наблюдать
crash - ломать
hiding - сокрытие
hit - ударять
hurriedly - поспешно
holidays - каникулы
responsibility - ответственность
provides - предоставлять
observations - наблюдения
define - определять
lock - закрывать
claim - заявлять
speak - говорить
talk - разговаривать
state - состояние
cinema - кинотеатр
behavior - поведение
blow - дуть
just - просто
programming - программирование
notice - замечать
dirty - грязный
similar - схожий
abroad - заграница
commonly - обычно
break - ломать
perform - выполнять
dirt - грязь
say - сказать
accept - принимать
blueprint - чертеж
appear - отображать
operate - функционировать, действовать
provide - предоставлять
look for - искать
interaction - взаимодействие
complete - завершать
wall - стена
